#######################################
# Syntax Coloring Map SPI
#######################################

#######################################
# Datatypes (KEYWORD1)
#######################################
SPIClass	KEYWORD1
SoftSPI	KEYWORD1
SPI	KEYWORD1

#######################################
# Methods and Functions (KEYWORD2)
#######################################
SPISettings	KEYWORD2
begin	KEYWORD2
end	KEYWORD2
beginTransaction	KEYWORD2
endTransaction	KEYWORD2
setPins	KEYWORD2

transfer	KEYWORD2
transfer16	KEYWORD2
setBitOrder	KEYWORD2
setDataMode	KEYWORD2
setClockDivider	KEYWORD2
flush	KEYWORD2
done	KEYWORD2

#######################################
# Constants (LITERAL1)
#######################################
USE_SOFTWARE_SPI 	LITERAL1

SPI_CLOCK_DIV2	LITERAL1
SPI_CLOCK_DIV4	LITERAL1
SPI_CLOCK_DIV8	LITERAL1
SPI_CLOCK_DIV16	LITERAL1
SPI_CLOCK_DIV32	LITERAL1
SPI_CLOCK_DIV64	LITERAL1
SPI_CLOCK_DIV128	LITERAL1

SPI_MODE0	LITERAL1
SPI_MODE1	LITERAL1
SPI_MODE2	LITERAL1
SPI_MODE3	LITERAL1